0100111100110010001101001100011101011101010101010010100000110011011100001011010110001011001011100111
0100011010111010010000111001110100111000010111011010011101010100100111001111110000011110011111001001
1010011101001001100001100110111111101110101011001110010001101011110110111011101011010111100101000101
1111111001001111011101110011011110101011110100011110010101101000011101111011100111011011010011010011
0110110101110111111100100000110011010110001010111011000110110101100000011111111111110111011010011111
1111111101111101011101101101110111110011011011100010111000110001001111001111111110011111100100011001
1111010010011111011010000101100001110111110101011001101110100011110001100101100011110100100011111011
1101101011011010100110011111111101011111101110101111110111111110000000110011010111110111011110111100
0001100010101111110111001011101001111100001111011110100000000001100010111111111010110011101011011110
0100101001111000101010011101011001101010111211110010000011011010111101111110011001100001010010110110
1111101101110111101011111001101111001101100111100111101101001011111111111011011111110101111100111101
1100000110111100011101000101011101011101101110010111000001111100101111001010110110010011000111100111
1001111010110111010010001011010110011110111010110111111010100111111100010011100000011111101011101111
1111010111101001101110000111010001110111011110101111110101010011111110110001110111110111011010011110
1101111000101111000011100101010000111110011111011101011010011000101101101010011001010000000011100000
1111100110111101011111101001011010011011010010001101101110011111001001011110111000101011011001011000
1101010110010110111000110101011010111101011001110111101001111111111011111101010011110110111101000101
0100101001101101111001101111100111110001011001011101101101000000101101100111001101100101100101101111
0101111111101110101011111100011100001011010111010011110110101110010011110111101111010111111011011101
1111010011101111100010111001101110010011101010111100111111110101111011111001111101101001001111101101
1000001101111010100111101010001111010001111101011011110111111001010011101000111101011111111010100111
0011111001100110111011101101011010110111111010101000110110100111001101010111110111011101001011101111
1111100111000011100110111111111010111101111000001111010011111110111011111101001001101001010011111100
1101011001111010110111110001110111010011101101101001010110101111101100111111101110110100111101010110
1111111011110100010101000001001111001111110111011001001100110110101111000010001011010111011011111101
0011011010011111011011101110111111110111111010011101101100110111101100111001100010001110010101101100
1011000111100100111101000100010101110111011101001011101111011001110110100110111001111011111011001101
0001100010010110001000101101011101001111110101111101101000011111111001111001001101011111110101110101
0110111110111010010011100001101010100111111010110110111110000111101111111000001111000001111110011110
0111100110111101011110101010001000100100100111110010101100011101101000111100101011011101010011110101
1011101110110111100011100110110100010101111101111110101010101101100111110010011011011101101111101001
0100111100110101011111101011101110111010111110111001111010111110101111111011101110100011010011110101
1010101100111011101100000000101110111110100101111001101100101011110110110100111111001110011101001110
0011111111111011100011111111101111100110001111011001111111111011011111111010101101111001000111111111
0110001011111111000111001111110000010111010101111010110001111101001100101001110111111111110110101111
1101100010111111111111111110111111110111100111111011111111111101010010101111110101010101111111100111
1011110111100111100010111101111011110100111110111011000100010101111000100111101000011110101111110110
0111111100111111110110000010001001011110001011101000111011100111000010010101110101110111111011000111
1101100111011000111111111110000101110101100111011111111011101010001101100111111110011111001111110100
1010111110011111100111101101111110110111110001011110111100001101101111111001100111011110111101010111
1000001111000011001011111100000011110011010011100011010001010110011100011100011001101000110111011111
0110101000101110111111011011100011101010011101101101100011101111111011011110001111100010110111111011
0111011101111010001011001101011100101001011000011111011111110000000100110111100111001110011110011101
1111011011010010011110111100111000100100001101111000011010111101011011101111011100110011011101110111
0100000101001111000101111000101001100001111110000100101011111000101010010101100101111110111111110111
1101101001011001111000101011101101111111010010101000100111111011110110101111011101011111010001111100
1101011111011011001001111110110110101011110100100010100111011011000010011100000111111111110111001011
1111000101101010011011001111100100001111101110100010101101111011000101011001010100100100110000011011
1011101111110111000111101011000011010110011101011000111001100011011111111101100101111110101101101101
1100011010111000110010101011111011010010000011011000110101011011111000100101001111010110100110111111
0100011110111111011100011110110010001100001000111000111011001100100101011010110111011111111110100111
0111100010100111011001111011101111111111010100111010000111000110110111111011101110111111110100101001
0111100100101001111111011011110001111111111011111011111111101101010011100101001110011010011010100110
1100110110110110011011010010101111011000111111111110111101001010011011011111011000100111001110000110
1101000100000111111111100110110110111011000101011100111100100010111011111101100101110010100010110010
0110100111111011101001011101110011010011011100110111110111101011001111110101111011101000010110010001
1110001111011001110111111110100000110111110001000010010100011100111011101111111101011011101010101111
0111100011001011111110111011101011011001010011110100011111011010101111111101101001101111111101101101
0101001101111010010110100001101111010001010010111111111100111011100111111110011101111000100101011001
1111101010011010110101011010101101110011000011111011111010101010101111101000101000001011111110111000
1111000101111111100000011001110101111101111011000101101100001111011111101001111010001111110110111000
0110110011111001011111101001110000111001000100001011011001011110111100001000010011001011100111111100
1101101111000011011011011011110011000010110110110111010101111111000000111101010110011110111010011111
1000001001110101111110101111010111011001110000111010101001101110011001010111001101110011111110010011
1111101111010110110111100011111110001111011111001100011110111011110001111100010010100101010011010011
1101100101100111111000000110110000110110111111010111010111001011111000101011001001110111110011001100
0101001111111000010010110001011101100001111100111011001111011010110111101010101111011010110101001101
1010000110100011101110101010111101011100001101000100111011101101111101010101111101111011011011101111
0110011111011001111111111010111110111110110101010111110001111101110111010010111110110101010011001011
1111111010101110111101101000110011111111101111000011100011011010111011100011101011100110110011111000
1111001110100010100110100010011100101001110111100111010001011101100110110111010000111011001000101100
0001111011100000010000101111001100010011011110111011001111000111111010101011111011111001111111011101
1111001001100001001101110101110010011011011101101101010111000101110100001011111100100110111011010101
1110001010111001111110110110000110101111011111011111110111000111011101111010110011110010101000010011
1011111101100001110110011110111011111010110011101011111100111110111110110101010100100001111011100011
0100000111111011111101000101101011110011100011010110110110110000010011110111111000001111111011001110
1101100101100110110111101110010110001010001110111100100011010010000100011011101110001001101010000111
0011100110101101100100101000111001011111011001011101110011110110001101001001011101000101000111110001
0011101011111011100111001110001100101100011011001111001101111010111000110110110111110111100100111100
0001100111111000100110100110100011110111111111110110011111101011100101100110010001010110001100111110
0111011101000110111110110110111100011011110111111010000001100110100000011110110110100001010010100010
0101101101000100101001101010111011000010100010100111001111001111011100110111111011101011101100000100
1111111101011011011011011001110011100001101111111101110011111001010010011100011100011000011110110111
0111011110011011101000101101001001011100000011010011111110111000100111111010010011011111111101111011
1101001010001011011010110000010000101010101101011011111110110011110011010011000011001111111010111011
0111010100101001011000010111001011001101011101010010100110011011010000011111001001101100101111110011
0011010110010100011101011010011000101101110111010110011110010111010010100011110010111111110011011011
0000110011110011001111001110111110110110110111010011010011111101101001111011110001011111011110011111
0111110110011000010110101100001101101110000111001110000011110000101111110011001110010001111110000010
1101101111011011011110111101100000110011011100101011000001110111001100111101001101111001001101101110
0101111001110011010111001110011010111110101111010100000000101001000111010311101110111111010010111111
1111011011111111100001110001101111001011111010110011011100101011100011101111110010110010011110001101
1110110111100111010001111101101011011111011110000110101010111001011111101011000101011111111111100000
1101011110001111111111111100101110111100001001000011111100011001110111011011101011011101001111011100
1100110111011100111101111110000111111111010100000110001010101111110100110001011111001010100101101010
1000011000110101010110011111001100111101110100110010010100011010101010110011100111100101011011011001
1011111011010111111111011010111111110101010011011111111111111011010110101011010000111011110000000010
0101011110101011101110110001001111110110011110111111101000110010111010000110110111011000011111101011
1001001011000100110111100110110101001111101101010110101011111111111100110010000111111010100111110100
1111111000011011001111111111111011111100101100101110111111101111110001110101111100000000111111001100
