010110111100010110101011010111011010001011001011001111000111
110110011110110110010010111111000100100010001101011010011111
111101001101111110110111011001001011111010101100110111000011
011110011101001111010101101101101111011101101100111111111011
111101111111111010010101010100011010111001100111100001101111
001111111001111001100101111011110010101111000111111011111100
001101010111101111110001101100000110110101011001111111011100
111011101100111111011100100111110001100100111110111100100011
111111010111011110111110111101011111011111111010110111110010
101010111101101110001101111110101111101111000101111101010111
111111100100011111111011101011100001110011110001100011111111
111110111101001111100101001000111011111111011111110010010000
111011100111110010001001001100111111110110000010011101000001
110110001010010001100111011101111111111010111111010111111110
011000110111100101101001001110001110110100011100111100100111
100110111100110111101001010011010111110111001110100001101111
100101010001101100101001110111011100100110011011010100001110
011101110100100000001110111000101001111111011000001011111100
111110111011010011100111011101101111111111000111110011010111
010100001111001110111101021111110111000111111001011001010110
101100111101110111111111111110011011011110011001110110011001
101101101010000101010100110001010101110110000110010101101110
101110100011000001101000010011111011010001111111111111100000
101110110011111101110011101111010010011101111101111100011101
111111111101101110001110110101111101101111100001111110011011
010110111111110111000110100111101111111111001101111111011001
001100011000011011110110011111101101111011011111011000001101
001010100111001011010010101011111101100010001101101111101010
111101011110111111100010111111110110101010010010011001110110
101111111011111111001111000001100100111101111110001101110111
111011111110111111101000010101111110111000001111101111000100
100110011110000111100001001101000010111010111001001111000100
111100110111110111011110110110100110110011111111110010110011
001101101010100011110111001110001101100000111101111011001011
101110111001101111111110010011111110001111111110111110111100
101111001100110011101011110011100111100110110001111111110010
000111010110011110101111010111111100001011100101011111101111
100011101001110011111111101010100010111101010100001010011101
111011101101100010101101101100000110011111011101110010100101
101101101101111100101110111111011011101111000111111111100011
110101101101010101011011110111111101110000011110111011101111
111000010011000011111100111011111110100001000101110110111101
001101101000100101111101001101100110000010111010110010111001
011100101010001111001101011101001110011010010110110111100011
010110110110111110011011010011000010101011111101111110000110
011001101110110100111111101111100100101010100011111010011010
100011001110100101010000011111110111110110111111001010111113
101011100100100001000111111001010011011101010000001001111010
000101101101011110000011010010111110111101110101010001111001
101101100011101010011000011100111110101001111001111110001111
111100010100000110110001001100100110110001111001000100111101
000101110101110010110110000010001111001110101001110100011101
011001011111011100110110101001100011011111100110001111000111
000111101111111000101111111101010000110010001110001111011101
000111100101010011100111011001100001101110000001011101110111
100111010111010001111010101010101000101111010011111110100111
001010110111101011111111110000110101001100101010001101111111
101110111010101011111010010110101101101011111110101111110110
001001100111100111101101010111100110001100100101111110011011
001010000010100001101111011001010101010010111110110011001101
