0011111101
1120101101
0011000111
0010101111
0101101010
0101131101
0011111100
0010011011
1011001010
1110010011
