000000000000000000000000000000000000000000000000000000000000
010100101100000011000010000101000100110003100010010001110010
010001100000000000100000010000000000100011000101000001100010
010110100000110111000000110101010110000010011010000000001100
001000110100100001000110001000000100001110011110110100000010
010100000010100001101010000001001000001011010001010000000100
000100100010011111010010111111101000100111000011000001000010
000000001010000001110000100001100011000100011010001010000000
011000100001100000011111110011001110111100000101110000001001
001000101010101001010000000001111011100011011000000000010001
011000000100100000011101100000100001110001000101000010001001
010010001001101100110000001001100000001000001000111011000000
000100011100000000101110100001000000000110100001000011101001
010000000000010000111011110001001001000100101100110100010000
010000010100000110000100100110000100100101010010001001010000
000000001001100011000000100100100100001001100100001001000000
010000000010000001111000110111001001101000000000010011000101
000001000000001010011101110000000100010100000001001010000000
000000001000100010010111001000000000100000001010000000001010
001000100010000100010101000010000000000000000110001110000010
011000100101100010110000000001000000010000010101110110100010
000010101100111111110000000001100010000110100110100101001000
000101110000010100000000100100001000000000000000000100101000
000010100111110011000000000100001100100010110000101001001000
001000011010000010010010011010010010110000001010001001010000
010101100011011011000100010111000000000000000000001110000001
000111010001110000001100000010101000010111001101001010100010
000000000000011100101000000011011011010010110000100000000100
010000100010010100000011001001010010001100000000010100000001
010110000110010111110000010101100100100000000000001001001100
010000100100001100111100010101000000010011101000001101010000
001101011101000001101010000000001010000000011010100000011010
000010000000000001011110001001010011010010100000000010000001
000101000010000000000010010001000011000010011100101100010010
010000100000011101001110001000000101000001010000011000000000
001001000100001100001000001000110001110000100111100011001011
000000001100001010111000000100100010100000101000000000100100
011011000001000000110010000100111110101111010001110111000010
000000100000100101101100001000000000000010000011001001010010
000111100101111111001000100100010010000010100010001000001000
010001011001000011100001100000000100100000001010100100010100
000001100001101111101001001001101011100001100101000000001100
000000010100100010001000000010100000000001010010101001001000
010011100000110000000100011110010110000001000100000001000011
000111100110100001000010100000000100101000000000000000010000
000000000101111000100011100100110000101010110001000001000000
001000100000011000100011001000000100001000000000000010000101
000011010010010000000000100110001001001010000000100101000100
000100000101010001000100100001010000000111000100100001100001
000010010010010001001000000010011110100010001100001001000100
000001010100011110010110001010100010001110011001100000101111
000001000100000100000101111000100000000100001001000011000001
000010001000011100000001001110000010010101001010001010000010
010011000000101000000001101011100001001010100100000101100010
011110001100111011100000000001010110100100100101000111000011
000000010000100100001000100100100010101001111101000010000001
000011000000101000100100001001000101010000010001010000000100
011000000000111011000010001000100110000110100100000000101010
000000000100011000100101000000000000011000011010001001010000
010000001101001200000100100000101101000010100101001010001100
